Inhaltsverzeichnis.

 

maleitmm. sem

1. Die bisherigen Ergebnisse der Forschnng uber die sieben
weisen Meister und fiber die Steuung der hebraischen
Version (lischle Sendabar) ............. vll

Π. Die neu ausgefundene iateinische Ubersetzung der Mischle
Sendabar, ihre Stellung zum Original und Bedeutung im
Bahmen der okzidentalischen Gruppe . . . q ..... XII

Tabelle der Exi-zahlungen der orientalisehen Versionen . . . XXIII

Text.
Primi sapientis prima historia: Leo ............ 5
Primi sapientis secunda historia: Avis ........... 6
Reginae prima historia: [antor ............. 8
Secundi sapientis prima historia: Turtures ........ 9
Secundi sapientis secunda historia: Catula ......... 9
Reginae secunda historia: striga 4- Fons ......... 11
Tertii sapientis prima historia: Canls ........... 14
Tertii sapientis secunda historia: Paulum ......... 15
Reginae tertia historia: Simia .............. 16
Quarti sapientis prima historia: Panes .......... 17
Quarti sapientis secunda historia: Zuelura ........ 18
Reginae quarta historia: Aper .............. 19
Quinti sapientis prima hisioria: Balneum· ........ 20
Quinti sapientis secunda historia: Gladius ......... 21
Reginae quinta historia: Absalon rebellas ........ 23
Sexti sapientis prima historia: Absalon mortuus ...... 24
Sexti sapientis secunda historia: Nomius ......... 25
Septimi sapientis prima historia: Juvenis senilia ..... 26
Septimi sapientis secunda historia: Gibbosi ........ 28
mii regis historia: Inclusa ............... 30

(Βοιωτίη ...................... 33

